NNNNNNNNNNNNNNNNNNNNNNNNNNNMMMMMMMNNNNNNNNNNNNNNN
NNNNNNNNNNNNNNNNNNNNNMMMNNNNNMMMMMNNNNNNNNNNNNNNN
NNNNNNNNNNNNNSSSSSSNNNNNNNMMMMMNNNNNNNNNNNNNNNNNN
NNNNNNNNNNNNNSSSSSSSNNNNNNNNNMMMNNNNNNNNNNNNNNNNN
NNNNNNNNNNNNNNNNSSSSNNNNNNNNNNNMMMNNNNNNNNNNNNNNN
NNNNNNNNNNNNNNNNNNSSSSSNNNNNNNNNNNMMNNNNNNNNNNNNN
MMMNNNNNNNNNNNNNNNNNNSSSNNNNNNNNNNNNNNNNNNNNNNNNN
MMMMMMMNNNNNNNNNNNNNNNMMNNNNNNNNNNNNNNNNNNNNNNNNN
MMMMMMMMMMNNNNNNNNNNNNMMMNNNNNNNNNNNNNNNNNNNNNNNN
MMMMMNNNNNNNNNNNNNNNMMMMMNNNNNNNNNNNNNNNNNNNNNNNN
MMNNNNNNNNNNNNNNNNNNNNNSMNNNNNNNNNNNNNNNNNNNNNNNN
NMNNNNNNNNNSSSSSNNNNNSSSNNNNNNNNNNMMNNNNNNNNNNNNN
NNNNNNNNSSSSSNNNNNSSSSSSNNNNNNNNNMMNNNNNNNNNNNNNN
NNNNNNSSSNNNNNNSSSSSSSSSNNNNNNNNNNMMMNNNNNNNNNNNN
NNNNNNNNNNSSSSSSSSSSSSSSSSSSSSNNNNNMMNNNNNNNNNNNN
NNNNNNNNNNSSSSSSSSSSSSSSSSSSSSNNNNNMMNNNNNNNNNNNN
NNNNNNNNNNSSSSSSSSSSSSSSSSSSSSNNNNNMMNNNNNNNNNNNN
NNNNNNNNNNSSSSSSSSSSSSSSSSSSSSNNNNNMMNNNNNNNNNNNN

