NNNNNNNNNNNNNNNNNNNNNNNNNNNMMMMMMMNNNNNNNNNNNNNNN
NNNNNNNNNNNNNNNNNNNNNMMMNNNNNMMMMMNNNNNNNNNNNNNNN
NNNNNNNNNNNNNSSSSSSNNNNNNNMMMMMNNNNNNNNNNNNNNNNNN
NNNNNNNNNNNNNSSSSSSSNNNNNNNNNMMMNNNNNNNNNNNNNNNNN
NNNNNNNNNNNNNNNNSSSSNNNNNNNNNNNMMMNNNNNNNNNNNNNNN
NNNNNNNNNNNNNNNNNNSSSSSNNNNNNNNNNNMMNNNNNNNNNNNNN
MMMNNNNNNNNNNNNNNNNNNSSSNNNNNNNNNNNNNNNNNNNNNNNNN
MMMMMMMNNNNNNNNNNNNNNNNNNNNNNNNNNNNNNNNNNNNNNNNNN
MMMMMMMMMMNNNNNNNNNNNNNNNNNNNNNNNNNNNNNNNNNNNNNNN
MMMMMNNNNNNNNNNNNNNNNNNNNNNNNNNNNNNNNNNNNNNNNNNNN
MMNNNNNNNNNNNNNNNNNNNNNSNNNNNNNNNNNNNNNNNNNNNNNNN
NMNNNNNNNNNSSSSSNNNNNSSSNNNNNNNNNNMMNNNNNNNNNNNNN
NNNNNNNNSSSSSNNNNNSSSSSSNNNNNNNNNMMNNNNNNNNNNNNNN
NNNNNNSSSNNNNNNSSSSSSSSSNNNNNNNNNNMMMNNNNNNNNNNNN
NNNNNNNNNNSSSSSSSSSSSSSSSSSSSSNNNNNMMNNNNNNNNNNNN
NNNNNNNNNNSSSSSSSSSSSSSSSSSSSSNNNNNMMNNNNNNNNNNNN
NNNNNNNNNNSSSSSSSSSSSSSSSSSSSSNNNNNMMNNNNNNNNNNNN
NNNNNNNNNNSSSSSSSSSSSSSSSSSSSSNNNNNMMNNNNNNNNNNNN

