NNNNNNNNNNNNNNNNNNNNNNNNNNNMMMMMMMNNNNNNNNNNNNNNN
NNNNNNNNNNNNNNNNNNNNNMMMNNNNNMMMMMNNNNNNNNNNNNNNN
NNNNNNNNNNNNNSSSSSSNNNNNNNMMMMMNNNNNNNNNNNNNNNNNN
NNNNNNNNNNNNNSSSSSSSNNNNNNNNNMMMNNNNNNNNNNNNNNNNN
NNRRRRRRRNNNNNNNSSSSNNNNNNNNNNNMMMNNNNNNNNNNNNNNN
NNNNNNNNRNNNNNNNNNSSSSSNNNNNNNNNNNMMNNNNNNNNNNNNN
MMMNNNNNRNNNNNNNNNNNNSSSNNNNNNNNNNNNNNNNNNNNNNNNN
MMMMMMMNRRRRRRRRRRRRRRNNNNNNNNNNNNNNNNNNNNNNNNNNN
MMMMMMMMMMNNNNNNNNNNNRRRRRRRRNNNNNNNNNNNNNNNNNNNN
MMMMMNNNNNNNNNNNNNNNNNNNNNNNRNNNNNNNNNNNNNNNNNNNN
MMNNNNNNNNNNNNNNNNNNNNNSNNNNRNNNRRRRRRRRRRRNNNNNN
NMNNNNNNNNNSSSSSNNNNNSSSNNNNRRRRRNMMNNNNNNRNNNNNN
NNNNNNNNSSSSSNNNNNSSSSSSNNNNNNNNNMMNNNNNNNRRRRNNN
NNNNNNSSSNNNNNNSSSSSSSSSNNNNNNNNNNMMMNNNNNNNNNNNN
NNNNNNNNNNSSSSSSSSSSSSSSSSSSSSNNNNNMMNNNNNNNNNNNN